▓▓▓▓▓▓▓▓▓▓▓▓▓▓▓▓▓▓▓▓▓▓▓▓▓▓▓▓▓▓▓▓▓▓▓▓▓▓▓▓▓▓▓▓▓▓▓▓▓▓▓▓
▓▓▓▓▓▓▓▓▓▓▓▓▓▓▓▓▓▓▓▓▓▓▓▓▓▓▓▓▓▓▓▓▓▓▓▓▓▓▓▓▓▓▓▓▓▓▓▓▓▓▓▓
▓▓▓▓    ▓▓▓▓                            ▓▓▓▓    ▓▓▓▓
▓▓▓▓    ▓▓▓▓                            ▓▓▓▓    ▓▓▓▓
▓▓▓▓    ▓▓▓▓    ▓▓▓▓▓▓▓▓████    ▓▓▓▓    ▓▓▓▓    ▓▓▓▓
▓▓▓▓    ▓▓▓▓    ▓▓▓▓▓▓▓▓████    ▓▓▓▓    ▓▓▓▓    ▓▓▓▓
▓▓▓▓            ▓▓▓▓            ▓▓▓▓            ▓▓▓▓
▓▓▓▓            ▓▓▓▓            ▓▓▓▓            ▓▓▓▓
▓▓▓▓▓▓▓▓▓▓▓▓▓▓▓▓████    ████████████▓▓▓▓▓▓▓▓    ▓▓▓▓
▓▓▓▓▓▓▓▓▓▓▓▓▓▓▓▓████    ████████████▓▓▓▓▓▓▓▓    ▓▓▓▓
▓▓▓▓            ▓▓▓▓            ▓▓▓▓    ▓▓▓▓    ▓▓▓▓
▓▓▓▓            ▓▓▓▓            ▓▓▓▓    ▓▓▓▓    ▓▓▓▓
▓▓▓▓    ▓▓▓▓    ▓▓▓▓▓▓▓▓████    ▓▓▓▓    ▓▓▓▓    ▓▓▓▓
▓▓▓▓    ▓▓▓▓    ▓▓▓▓▓▓▓▓████    ▓▓▓▓    ▓▓▓▓    ▓▓▓▓
▓▓▓▓    ▓▓▓▓                    ▓▓▓▓            ▓▓▓▓
▓▓▓▓    ▓▓▓▓                    ▓▓▓▓            ▓▓▓▓
▓▓▓▓    ▓▓▓▓    ▓▓▓▓▓▓▓▓▓▓▓▓▓▓▓▓▓▓▓▓▓▓▓▓▓▓▓▓▓▓▓▓▓▓▓▓
▓▓▓▓    ▓▓▓▓    ▓▓▓▓▓▓▓▓▓▓▓▓▓▓▓▓▓▓▓▓▓▓▓▓▓▓▓▓▓▓▓▓▓▓▓▓
▓▓▓▓    ▓▓▓▓    ▓▓▓▓                            ▓▓▓▓
▓▓▓▓    ▓▓▓▓    ▓▓▓▓                            ▓▓▓▓
▓▓▓▓    ▓▓▓▓▓▓▓▓▓▓▓▓    ▓▓▓▓▓▓▓▓▓▓▓▓▓▓▓▓▓▓▓▓    ▓▓▓▓
▓▓▓▓    ▓▓▓▓▓▓▓▓▓▓▓▓    ▓▓▓▓▓▓▓▓▓▓▓▓▓▓▓▓▓▓▓▓    ▓▓▓▓
▓▓▓▓                    ▓▓▓▓                    ▓▓▓▓
▓▓▓▓                    ▓▓▓▓                    ▓▓▓▓
▓▓▓▓▓▓▓▓▓▓▓▓▓▓▓▓▓▓▓▓▓▓▓▓▓▓▓▓▓▓▓▓▓▓▓▓▓▓▓▓▓▓▓▓▓▓▓▓▓▓▓▓
▓▓▓▓▓▓▓▓▓▓▓▓▓▓▓▓▓▓▓▓▓▓▓▓▓▓▓▓▓▓▓▓▓▓▓▓▓▓▓▓▓▓▓▓▓▓▓▓▓▓▓▓
